---------------------------------------------------------------------------------------------------------------------------------------------
---------------------------------------------------------------------------------------------------------------------------------------------
---------------------------------------------------------------------------------------------------------------------------------------------
---------------------------------------------------BBBB--------------------------------------------------------------------------------------
--------------------------------------------------B---------------------------------BBBBBBBBBB----------------------B------------------------
-------------------------------------------------B---------------------------------------------------BBBB--B-----B--------B------------------
------------------------------------------------B------------------------BBBBBBBBB----------------------------B--------B---------------------
--------------------BBBBBBBBBB----BBBB---------B------------------------B-----------------------BBB------------------------------------------
----------------B---b-------------------------B------------------------B------------BBBBBBBBBB--------------------------------BBBBB----------
---------------Bb---b-------------------BBBB-B-------------BBB--------B------------------------------------------------------BbbbbbB---------
---H----------Bbb---b-------------------bbbbB-----------------B------B-------------------------------------------------------bbbbbbbB--------
---------------------------------------------------------------------------------------------------------------------------------------------